NO textures/1.png
SO textures/2.png
WE textures/3.png
EA textures/4.png
C , , 
F 122,122,122
 
111111
111101
101001
101001
101001
101001
101001
1000N1
111111

