NO textures/1.png
SO textures/2.png
EA ./textures/4.png
WE textures/3.png

C 122,122,122
F 122,122,122

111111
100101
101001
1100N1
111111
